Hh, Hh, Hh^Fp, Gs^Fp, Gs^Fp, Hh, Hh, Gs^Fp, Gg, Rp, Gs^Fp, Gs^Fp, Gs^Fp, Re, Gs^Fp, Hh^Fp, Hh^Fp, Gs^Fp, Gs^Fp, Hh, Hh, Hh
Hh, Hh, Hh, Gs^Fp, Gs^Fp, Hh, Hh, Gg, Gg, Rp, Gg, Gs^Fp, Gg^Vh, Re, Gg, Hh, Hh, Gs^Fp, Gg, Hh, Hh, Hh^Fp
Hh, Hh, Gs^Fp, Gg, Gg, Hh, Gg^Vh, Gg, Rp, Rp, Gg, Gg, Gg, Re, Re, Gg, Re, Re, Gg^Vh, Gg, Gg, Gs^Fp
Hh, Hh, Gg, Gg, Gs^Fp, Gg, Gs, Rp, Gs, Gg, Hh, Gs, Hh, Gg, Gg, Re, Gg, Gg, Gg, Gg, Gg, Gs^Fp
Gs^Fp, Gs^Fp, Gs, Gg, Gg, Gg, Gg, Rp, Re, Hh, Hh, Hh, Gg, Gs, Gg, Re, Re, Gg, Gg^Efm, Gg^Efm, Gg, Gg
Hh, Hh, Gg^Vh, Re, Re, Gg, Gs^Fp, Rp, Ce, Gs^Vh, Ce, Gs, Gg, Gg, Gs, Gg, Re, Gg, Gg, Gg, Re, Re
Hh, Hh, Hh, Hh, Gg, Re, Re, Rp, Ce, 3 Ke, Ce, Gs, Re, Gg, Re, Re, Gs, Re, Re, Re, Gg, Gg
Mm, Mm, Hh, Gg, Ce, Gg, Gs, Rp, Re, Ce, Gs, Re, Gs^Vh, Re, Gg, Re, Gg^Vh, Gg, Gg, Gg^Efm, Gg, Gg
Hh, Hh, Gg, Gg, Gs, Gg^Vh, Re, Rr, Qxe, Re, Re, Re, Gg, Gs, Gg, Gg, Gg, Gg, Gg, Gg, Gs^Fp, Gs^Fp
Gs^Fp, Gg, Gs, Gg, Re, Re, Re, Qxe, 4 Cud, Qxe, Re, Ce, Gg, Gg, Hh, Gg, Gg, Gg, Gg, Gg, Gs^Fp, Gs^Fp
Gg, Gg, Re, Re, Ce, Gs, Re, Qxe, Qxe, Qxe, Re, Hh, Hh, Gg, Gg, Gg, Gg, Gg^Efm, Gg, Gs^Fp, Ww, Ww
Re, Re, Gg^Efm, Gg, Ce, Ce, Gg, Re, Re, Re, Ce, Hh, Gg, Gg, Gg, Gg, Gs^Fp, Gg, Ww, Ww, Gs^Fp, Gs^Fp
Gs^Fp, Gg, Gg, Gg, Gg, Gg^Vh, Re, Gs, Re, Ce, Gg, Gg, Gg^Vh, Gg, Gg, Gs^Fp, Gs^Fp, Ww, Gs, Gs^Fp, Gg, Gg
Gs^Fp, Gs^Fp, Hh, Hh, Hh, Gg, Gg, Re, Gs, Re, Re, Gs, Re, Gg, Gg, Ss, Ww, Ww, Gg, Gg, Gg, Gg
Hh^Fp, Hh, Hh, Hh, Gg, Gg, Gs, Re, Gg, Gg, Gs, Re, Re, Gg, Gs, Ss, Ww, Gg, Re, Gg^Vh, Gg, Gg
Aa^Fpa, Hh, Mm, Hh, Gg^Vh, Re, Re, Re, Gg, Gg, Gg, Gg, Re, Gg, Ww, Ww, Gs^Fp, Gs^Fp, Re, Gs^Fp, Hh, Hh
Mm, Mm, Mm, Mm, Hh, Gs, Gs^Fp, Re, Gg, Gg, Gs, Gg, Gg, Re, Ww^Bw\, Gs^Fp, Gs^Fp, Gs^Fp, Re, Hh, Hh, Hh^Fp
Mm, Mm, Mm, Mm, Hh, Gg, Re, Re, Gg, Gg, Gg, Gg, Gg, Gg, Ww, Re, Re, Gs, Ce, Gs, Gs^Fp, Gs^Fp
Mm, Mm, Mm, Aa^Fpa, Hh, Hh, Gg^Vh, Hh, Hh, Hh, Gg, Gg, Gg, Ww, Gs^Fp, Gs^Fp, Re, Ce, 1 Ke, Ce, Gs^Fp, Gs^Fp
Mm, Mm, Mm, Mm, Aa^Fpa, Mm, Mm, Hh, Hh, Gg, Gg, Gg, Ww, Ww, Gg, Gs^Fp, Re, 2 Ce, Ce, Ce, Hh, Hh^Fp
Mm^Xm, Mm^Xm, Mm^Xm, Mm, Mm, Mm, Mm, Hh, Gs^Fp, Gg, Gg, Gg, Ww, Gs^Vh, Re, Gs^Fp, Re, Gs^Fp, Gg^Fet, Hh, Mm, Mm
Mm^Xm, Mm^Xm, Mm^Xm, Mm, Mm, Mm, Mm, Hh^Fp, Gs^Fp, Gs^Fp, Gg, Gg, Ww, Gs^Fp, Gs^Fp, Re, Re, Gs^Fp, Gs^Fp, Hh^Fp, Mm, Mm
