Gll^Fp, Gll^Fp, Gll^Fp, Gs^Fp, Gll^Fp, Gll^Fp, Gll^Fp, Gll^Fp, Gll^Fp, Gll^Fp, Gll^Fp, Gs^Fp, Gll^Fp, Gs^Fp, Gs^Fp, Gll^Fp, Gs^Fp, Gll^Fp, Gll^Fp, Gll^Fp, Gll^Fp, Gll^Fp
Gll^Fp, Gll^Fp, Gll^Fmw, Gll^Fp, Gs^Fp, Gll^Fmw, Gs^Fp, Gll^Fp, Gll^Fdw, Gll^Fp, Gll^Fp, Gll^Fp, Gll^Fdw, Gll^Fp, Gll^Fp, Gll^Fdw, Gll^Fp, Gll^Fp, Gll^Fp, Gll^Fmw, Gll^Fp, Gll^Fp
Gs^Fp, Gll^Fp, Gll^Fp, Gll^Fp, Gll^Fp, Gll^Fp, Gll, Gll^Fp, Rb^Es, Gll^Fp, Gll^Fp, Gll^Fmw, Gll^Fp, Gll^Fp, Gll^Fp, Gll^Fp, Hhd^Vo, Gll^Fp, Gll^Fdw, Gll^Fp, Gll^Fp, Gs^Fp
Gll^Fp, Gll^Fp, Gll^Fp, Gll^Fmw, Re, Rb^Es, Hhd, Rb, Hhd^Vo, Rb, Rb, Gll^Fdw, Rb^Es, Hhd, Hhd, Hhd, Hhd, Hhd, Gll^Fp, Gll^Fmw, Gll^Fp, Gll^Fp
Gll^Fp, Gll^Fdw, Gll^Fmw, Gll^Fp, Re^Es, Hhd, Mm, Hhd, Rb^Es, Rb^Es, Co, Rb^Es, Hhd, Mm, Mm, Mm, Mm, Hhd, Gs^Fp, Gs^Fp, Gll^Fp, Gll^Fp
Gs^Fmw, Gll^Fp, Gll^Fp, Re, Hhd, Mm, Mm, Hhd, Mm, Co^Es, 3 Ko, Co^Es, Mm, Mm, Hhd, Hhd, Mm, Hhd, Gll^Fdw, Gll^Fet, Gll^Fp, Gll^Fp
Gll^Fp, Gll^Fp, Gll^Fdw, Re, Re, Hhd, Hhd, Mm, Mm, Co^Es, Co^Es, Co, Mm, Hhd^Vo, Hhd, Re^Es, Re, Hhd, Hhd, Gll^Fp, Gll^Fmw, Gll^Fp
Gs^Fp, Gll^Fp, Gll^Fp, Re, Gll^Fmw, Re^Es, Re, Mm, Mm, Mm^Vc, Mm, Mm, Mm, Mm, Mm, Hhd, Re, Hhd, Re^Es, Gll^Fp, Gll^Fp, Gll^Fp
Gll^Fp, Gll^Fp, Gd^Fp, Gll^Vo, Gll^Fp, Gll^Fdw, Re, Hhd, Mm, Mm, Hhd, Mm, Hhd, Hhd, Hhd, Mm, Hhd, Re^Es, Re, Gll^Fdw, Gs^Fmw, Gll^Fp
Gs^Fp, Gll^Fp, Gd^Fmw, Re^Es, Re^Es, Re, Hhd, Mm, Hhd, Mm, Mm, Re^Es, Re, Hhd, Re^Es, Hhd, Hhd, Re, Gll^Fmw, Gll^Fp, Gll^Fp, Gll^Fp
Gd^Fp, Gd^Fp, Gd^Fp, Re, Re, Re, Hhd, Mm, Re, Hhd, Hhd, Mm, Hhd, Re, Hhd^Vo, Re, Gd^Fp, Re, Re^Es, Gs^Fp, Gs^Fp, Gs^Fp
Re, Re, Gd^Fp, Gd^Fp, Re^Es, Re, Hhd, Hhd, Re^Es, Re, Re, Hhd, Gd^Fp, Hhd, Gd^Fp, Gd^Fp, Re^Es, Re, Re, Gd^Fp, Gd^Fet, Gs^Fp
Gd^Fp, Gs^Fp, Gs^Fp, Gd^Fp, Gs^Fp, Gd^Fp, Gd^Fp, Hhd, Re, Gd^Fp, Gd^Vc, Re, Re, Gd^Fmw, Gd^Fp, Gs^Fmw, Re, Re^Es, Re, Gs^Fp, Gs^Fp, Gs^Fp
Gs^Fp, Gs^Fp, Gg^Fet, Gd^Fp, Gd^Fp, Re, Re, Re, Re, Gd^Fp, Gd^Fp, Gd^Fp, Re, Gs^Fp, Re, Gs^Fp, Gs^Fp, Re, Gs^Fp, Gs^Fp, Gs^Fp, Gs^Fp
Gs^Fp, Gs^Fp, Re, Gs^Fp, Gs^Fp, Re, Re, Re, Gs^Fp, Gs^Fp, Gs^Fp, Re, Re, Gs^Fp, Gs^Fp, Gs^Fmw, Gs^Fp, Re, Gs^Vc, Gs^Fp, Gs^Fp, Gs^Fp
Gs^Fp, Gs^Fp, Re, Re, Gs^Fmw, Gs^Fp, Gs^Vo, Re, Gs^Fp, Gg^Fet, Gs^Fp, Re, Gs^Fp, Gs^Fp, Gs^Fdw, Gs^Fp, Gs^Fp, Re, Re, Re, Re, Re
Gs^Fp, Gs^Fp, Gs^Fp, Gs^Fp, Gs^Fp, Gs^Fp, Gs^Fp, Re, Gs^Fp, Gs^Fmw, Gs^Fp, Gs^Fp, Gs^Fp, Gs^Fp, Gs^Fp, Gs^Fp, Gs^Fp, Gs^Fp, Gs^Fp, Gs^Fp, Gs^Fp, Gs^Fp
Gs^Fp, Gs^Fmw, Gs^Fp, Gs^Fp, Gs^Fp, Gs^Fp, Re, Re, Gs^Fp, Gs^Fp, Gs^Fp, Gs^Fp, Gs^Fp, Gg^Vc, Gg, Gs^Fp, Gs^Fp, Gg^Fet, Gs^Fp, Gs^Fp, Gs^Fp, Gs^Fp
Gs^Fp, Gs^Fp, Gs^Fp, Gg^Fet, Gs^Fp, Gs^Fp, Re, Gs^Fp, Gs^Fp, Gs^Fp, Gs^Fp, Gs^Fp, Gs^Fp, Gg, Ce, Ce, Ce, Gs^Fp, Gs^Fp, Gs^Fp, Gs^Fp, Gs^Fp
Gs^Fp, Gs^Fp, Gs^Fmw, Gs^Fp, Gs^Fp, Gs^Fp, Re, Gs^Fp, Gs^Fp, Gs^Fp, Gg^Fet, Gs^Fp, Gs^Fp, Gs^Fp, 2 Ce, 1 Ke, Ce, Gg, Gg, Gg^Vc, Gs^Fp, Gs^Fp
Gs^Fp, Gs^Fp, Gs^Fp, Gs^Fp, Gs^Fp, Gs^Vc, Gs^Fp, Re, Re, Gs^Fp, Gs^Fp, Gs^Fp, Gs^Fp, Gs^Fp, Gs^Fp, Ce, Gs^Fp, Gs^Fp, Gg, Gs^Fp, Gs^Fp, Gs^Fp
Gs^Fp, Gs^Fp, Gs^Fp, Gs^Fp, Gs^Fp, Gg, Gs^Fp, Re, Re, Gs^Fp, Gs^Fp, Gs^Fp, Gs^Fp, Gs^Fp, Gs^Fp, Gs^Fp, Gs^Fp, Gs^Fp, Gg, Gs^Fp, Gs^Fp, Gs^Fp
