Gs^Fds, Gs^Fds, Gs^Fds, Gs^Fds, Re, Gs^Fds, Rb, Re, Gs^Fdw, Gs^Fds, Gs^Fds, Gs^Fds, Gs^Es, Gs^Fds, Gs^Fds, Gs^Fds, Gs^Fds, Gs^Fds, Gs^Fds, Gs^Fds, Gs^Fds, Gs^Fds
Gs^Fds, Gs^Fds, Gs^Fdw, Gs^Fds, Rb^Es, Gs^Fdw, Re, Re^Es, Gs^Fds, Gs^Fds, Gs^Fds, Gs^Fds, Gs^Ve, Gs^Fds, Gs^Fds, Gs^Fds, Gs^Fds, Gs^Fds, Gs^Fds, Gs^Fds, Gs^Fds, Gs^Fds
Gs^Fdw, Gs^Fds, Re^Es, Re^Es, Ce^Es, Re^Es, Re^Es, Rb, Re^Es, Gs^Fdw, Rb^Es, Gs^Fds, Re^Es, Gs^Fds, Gs^Fds, Gs^Fds, Gg^Efm, Gg, Gg, Gs^Fds, Gs^Fds, Gs^Fds
Re, Rb^Es, Re^Es, Ce^Es, 3 Ke, Ce, Re^Es, Re, Gs^Fds, Re^Es, Re, Re, Gs^Es, Re, Gs, Gg^Efm, Gg, Gg, Gg, Hh, Hh, Hh
Re^Es, Re, Rb, Ce, Ce^Es, Ce, Gs^Fdw, Gs^Fds, Gs^Fds, Rb, Gs, Gs^Es, Gs^Fds, Gs, Gg^Es, Gs, Gs^Fds, Gs^Fds, Gs^Fds, Hh, Hh, Hh
Gs, Gs^Es, Gs, Re^Es, Re, Re^Es, Rb, Gs^Fds, Re, Gs^Es, Re, Gs^Fdw, Gs^Fds, Gs^Fds, Gg, Gs^Fds, Gs^Fds, Gs^Fds, Gs^Fds, Hh, Hh, Hh
Gs^Fds, Gs^Fdw, Gs^Fds, Gs^Es, Gs^Es, Gs^Fdw, Re, Re^Es, Gs, Rb, Re, Gs^Fds, Gs^Fds, Gg, Gg, Gg^Efm, Gg, Gg^Fet, Gs^Fds, Gg^Fet, Hh, Hh
Gs^Fds, Gs^Fds, Re^Es, Rb, Re, Gs^Fds, Gs^Fds, Gs, Re, Re, Gs^Fds, Gs^Fds, Gs^Fds, Gg^Ve, Gs^Fds, Gs^Fds, Gg, Gg, Gs^Fds, Gs^Fds, Gg^Fet, Gs^Fds
Re, Re, Gs^Ve, Re, Re, Re^Es, Gs, Gs^Es, Re, Gs^Fds, Gs^Fds, Gs^Fds, Gs^Fds, Gs^Fds, Gs^Fds, Gs^Fds, Gg^Efm, Gg, Gg, Gs^Fds, Gs^Fds, Gs^Fds
Gs^Fds, Gs^Fds, Gs^Fds, Gs^Fds, Gs^Fds, Gs^Fds, Gs, Re, Re, Gs^Fdw, Gs^Fds, Gs^Fds, Gs^Fds, Gs^Fds, Gs^Fds, Gg, Gg^Efm, Gs^Fds, Gs^Fds, Gs^Fds, Gs^Fds, Gs^Fds
Gs^Fds, Gs^Fds, Gs^Fds, Gs^Fds, Gs^Fds, Gg^Fet, Gs^Fds, Gg^Efm, Gg, Gg, Gg, Gg, Gg, Gg^Fet, Gs^Fds, Gs^Fds, Gs^Fds, Gg, Gg, Gg^Fet, Gs^Fds, Gs^Fds
Gs^Fds, Gs^Fds, Gs^Fds, Gg^Fet, Gg^Efm, Gs^Fds, Gg, Gg, Gs^Fds, Gg^Ve, Gs^Fds, Gs^Fds, Gs^Fds, Gg^Efm, Gg^Efm, Gs^Fds, Gs^Fds, Gg, Gg^Efm, Gs^Fds, Gs^Fds, Gs^Fds
Gs^Fds, Gg^Fet, Gs^Fds, Gg, Gg, Gg^Efm, Gg^Efm, Gg, Gg^Efm, Gs^Fds, Gs^Fds, Gg^Fet, Gs^Fds, Gg, Gs^Fds, Gs^Fds, Gs^Fds, Gs^Fds, Gg, Gs^Fds, Gs^Fds, Gs^Fds
Gs^Fds, Gs^Fds, Gs^Fds, Gs^Fds, Gg, Gs^Fds, Gs^Fds, Gg, Gs^Fds, Gg^Efm, Gg, Gs^Fds, Gs^Fds, Gg^Ve, Gs^Fds, Gs^Fds, Gs^Fds, Gg, Gs^Fds, Gg^Ve, Gs^Fds, Gs^Fds
Gs^Fds, Gs^Fds, Gg^Ve, Gs^Fds, Gs^Fds, Gs^Fds, Gs^Fds, Gs^Fds, Gg^Ve, Gg, Gg^Efm, Gs^Fds, Gs^Fds, Gs^Fds, Gs^Fds, Gs^Fds, Gg^Efm, Gg, Gs^Fds, Gs^Fds, Gs^Fds, Gs^Fds
Hh, Hh, Gs^Fds, Gg^Fet, Gs^Fds, Gs^Fds, Gs^Fds, Gs^Fds, Gs^Fds, Gg, Gg, Gg, Gs^Fds, Gs^Fds, Gg^Fet, Gs^Fds, Gg, Gs^Fds, Gs^Fds, Gg^Fet, Gs^Fds, Gs^Fds
Hh, Hh, Hh, Gs^Fds, Hh, Gs^Fds, Gs^Fds, Gs^Fds, Gg, Gg^Efm, Gs^Fds, Gg^Efm, Gg, Gs^Fds, Gg, Gg^Efm, Gg, Gg, Gg^Efm, Gs^Fds, Gs^Fds, Gs^Fds
Mm, Mm, Mm, Hh, Hh, Gg^Fet, Gg^Efm, Gs^Fds, Gg^Efm, Gg, Gs^Fds, Gs^Fds, Gs^Fds, Gg^Efm, Gg, Gg, Gg, Cv, Cv, Gg, Gs^Fds, Gs^Fds
Hh, Hh, Hh, Hh, Hh, Hh, Gg^Efm, Gg, Gg^Ve, Gs^Fds, Gs^Fds, Gs^Fds, Gg^Ve, Gs^Fds, Gg, Cv, 2 Kv, 1 Kv, Cv, Gg^Efm, Gg^Fet, Gs^Fds
Hh, Hh, Gg, Hh, Gs^Fds, Gs^Fds, Gs^Fds, Gs^Fds, Gs^Fds, Gs^Fds, Gs^Fds, Gg^Fet, Gs^Fds, Gs^Fds, Gg^Efm, Cv, Cv, Gg, Gg, Gs^Fds, Gs^Fds, Gs^Fds
Gg, Gg, Gs^Fds, Gg, Gs^Fds, Gs^Fds, Gs^Fds, Gs^Fds, Gs^Fds, Gs^Fds, Gs^Fds, Gs^Fds, Gs^Fds, Gs^Fds, Gs^Fds, Gg^Efm, Gg, Gg, Gs^Fds, Gs^Fds, Gs^Fds, Gs^Fds
Gg, Gg, Gs^Fds, Gg, Gs^Fds, Gs^Fds, Gs^Fds, Gs^Fds, Gs^Fds, Gs^Fds, Gs^Fds, Gs^Fds, Gs^Fds, Gs^Fds, Gs^Fds, Gs^Fds, Gs^Fds, Gs^Fds, Gs^Fds, Gs^Fds, Gs^Fds, Gs^Fds
