Gs^Fds, Gs^Fds, Gs^Fds, Gs^Fds, Gs^Fds, Gs^Fms, Gs^Fds, Gs^Fds, Gs^Fds, Gg, Re, Re, Re, Re, Rb, Re, Gs^Fdw, Gg, Gs^Fds, Gs^Fms, Gs^Fms, Gg, Gs^Fms, Gs^Fds, Gs^Fds
Gs^Fms, Gs^Fds, Gs^Fms, Gs^Fms, Gs^Es, Gs, Gs^Fms, Gs^Fmw, Gs^Fdw, Re, Re^Es, Rb, Ce^Edt, Re, Re^Es, Re, Gs^Fdw, Gs^Fmw, Gs^Fdw, Gs^Fds, Gs^Fds, Gs^Fds, Gs^Fds, Gs^Fms, Gg
Gs^Fds, Gs^Fms, Gs^Fms, Gg^Ve, Gs^Fds, Gs, Gs, Gs^Fdw, Re, Rb^Es, Rb^Es, Ce^Edt, 3 Ke, Ce^Edt, Rb^Es, Re^Es, Rb^Es, Gs, Re^Es, Gs^Fds, Gg^Ve, Gs^Fds, Gg, Gg, Gs^Fds
Gs^Fms, Gs^Fms, Gs^Fds, Gs^Fms, Gs^Fds, Gs^Fms, Gs^Es, Gs, Gs, Re, Re, Ce^Edt, Ce^Edt, Ce^Edt, Re, Re, Gs^Fdw, Gs, Gs^Fms, Re, Re, Gg, Gg^Efm, Gs^Fds, Gs^Fds
Gs^Fds, Gs^Fds, Gs^Fms, Gs^Fds, Gs^Fds, Gs^Fms, Gs^Fmw, Gs^Fdw, Rb, Re^Es, Re^Es, Re, Rb^Es, Re, Rb, Re^Es, Gs^Fdw, Gs^Fmw, Gg^Fet, Gs^Fms, Gs^Fds, Gg, Gs^Fds, Gs^Fds, Hh
Hh, Gs^Fds, Gs^Fms, Gg^Fet, Gs^Fms, Gs^Fms, Gs^Fds, Gs, Gs^Fmw, Gs^Fdw, Gs^Fdw, Rb^Es, Rb^Es, Re^Es, Re, Re, Gs^Fms, Gs^Fds, Gs^Fms, Gs^Fds, Gg^Efm, Gg, Hh, Gs^Fms, Hh
Hh, Hh, Gs^Fds, Gs^Fds, Gs^Fds, Gs^Fds, Re, Re, Gs^Es, Gs^Fmw, Gs^Fdw, Rb, Gs, Gs^Fdw, Gs^Fdw, Re, Re^Es, Gs^Fms, Gs, Gs^Fds, Gg, Gg^Efm, Gs^Fds, Hh, Hh
Hh, Gs^Fds, Hh, Gg, Gg, Gs^Fds, Gs, Gs, Gs^Fds, Gs, Gs, Re, Gs^Fms, Gs, Gs^Fds, Gs^Fms, Gs^Fms, Gs, Gg, Gg, Gs^Fds, Gs^Fds, Gs^Fds, Hh, Hh
Hh, Hh, Gs^Fds, Gs^Fds, Gs^Fms, Gg, Gs, Gg^Ve, Gs^Fms, Gs^Fds, Gs^Fds, Re, Gs^Fds, Gs^Fds, Gg^Fet, Gs^Fds, Gs^Fds, Gs, Gg, Gg^Ve, Gs^Fds, Gg^Fet, Gs^Fds, Hh, Hh
Gs^Fds, Hh, Gs^Fds, Gs^Fms, Gs^Fds, Gg^Efm, Gg, Gs^Fds, Gs^Fds, Gs^Fms, Gg^Efm, Gs, Gs^Fds, Gs^Fms, Gs^Fds, Gs^Fds, Gs^Fds, Gs^Fms, Gs, Gs^Fms, Gs^Fms, Gs^Fds, Gg^Fet, Gs^Fds, Gs^Fds
Gs^Fms, Gs^Fds, Gs^Fds, Gs^Fds, Gs^Fms, Gg, Gg, Gs^Fms, Gg^Efm, Gs^Fds, Gg, Gs, Gs^Fms, Gs^Fms, Gs^Fms, Gs^Fds, Gs^Fms, Gg, Gs^Efm, Gs^Fds, Gs^Fds, Gs^Fms, Gs^Fms, Gs^Fds, Gs^Fds
Gs^Fms, Gs^Fds, Gg^Ve, Gs^Fms, Gs, Gs, Gg, Gg^Efm, Gg, Gg^Efm, Gs^Fds, Gg, Gg, Gg^Efm, Gg, Gg, Gs, Gs, Gs, Gg^Efm, Gs^Fds, Gg^Fet, Gs^Fds, Gs^Fds, Gs^Fds
Gs^Fms, Gs^Fms, Gs^Fms, Gs, Gs^Fds, Gs^Fms, Gs^Fms, Gs^Fms, Gg, Gg, Gg^Ve, Gs^Fms, Gs^Fds, Gg, Gs^Fms, Gg, Gg^Ve, Gs^Fds, Gs^Fds, Gs, Gg, Gs^Fds, Gs^Fms, Gs^Fms, Gs^Fms
Gs^Fds, Gs^Fms, Gs^Fds, Gs, Gs^Fms, Gs^Fms, Gg^Fet, Gs^Fds, Gg, Gs^Fms, Gs^Fds, Gs^Fms, Gs^Fds, Gg, Gs, Gs^Fms, Gs^Fds, Gs^Fds, Gs^Fds, Gs^Fds, Gg, Gs^Fms, Gs^Fds, Gg^Ve, Gs^Fds
Gg, Gg, Gg, Gg, Gs^Fds, Gs^Fms, Gs^Fds, Gs^Fms, Gs^Fms, Gg, Gg, Gs^Fds, Gs, Gs, Gs^Fds, Gs^Fms, Gs^Fms, Gg^Fet, Gs^Fds, Gs^Fms, Gg, Gg, Gg, Gg, Gg
Gs^Fms, Gs^Fds, Gs^Fms, Gg^Efm, Gg^Efm, Gs^Fds, Gg, Gs^Fms, Gg, Gs^Fds, Gg, Gg^Efm, Gs, Gs^Fds, Gs^Fms, Gs^Fds, Gs^Fms, Gs^Fds, Gs^Fds, Gg, Gs^Fds, Gs^Fds, Gs^Fds, Gg^Efm, Gg
Gs^Fds, Gs^Fms, Gg^Ve, Gg, Gs, Gg, Gs^Fds, Gg, Gs^Fms, Gg, Gg^Efm, Gs, Gs^Fds, Gg, Gg, Gs^Fms, Gg, Gs^Fds, Gs, Gg, Gs^Fds, Gs^Fms, Gs^Fms, Gs^Fds, Gs^Fds
Gs^Fds, Gs^Fds, Gs^Fms, Gs^Fms, Gs, Gg, Gs^Fds, Gs^Fms, Gs^Fds, Gg, Gs^Fms, Gs^Fms, Gg^Fet, Gs^Fms, Gs^Fds, Gg, Gs^Fds, Gg, Gs, Gs^Fds, Gs^Fds, Gs^Fds, Gs^Fms, Gs^Fds, Gs^Fds
Gs^Fms, Gs^Fms, Gs^Fms, Gs^Fds, Gs^Efm, Gs^Fms, Gs^Fds, Gs^Fms, Gs^Fms, Gg, Gs, Gs^Fms, Gs^Fds, Gs^Fms, Gs^Fds, Gs^Fms, Gs, Gg^Efm, Gg^Efm, Gs^Fds, Gs^Fds, Gg^Ve, Gs^Fds, Gs^Fds, Gg
Hh, Gs^Fms, Gs^Fms, Gs^Fds, Gg, Gs^Fms, Gg^Ve, Gs^Fds, Gs^Fds, Gs^Fds, Gs, Gs^Fds, Gs^Fds, Gs^Fms, Gs, Gs, Gs^Fms, Gg, Gs^Fms, Gg, Gs, Gg, Gg, Gg, Gs^Fds
Hh, Gs^Fms, Gg, Gs^Fms, Gg^Efm, Gg, Gs^Fms, Gs^Fms, Gs^Fds, Gs^Fms, Gs, Gg^Efm, Gg, Gs^Fds, Gg, Gs^Fds, Gs^Fds, Gg^Ve, Gs^Fds, Gs^Fms, Gs, Gg^Efm, Gg, Gs^Fms, Gs^Fms
Hh, Hh, Gg^Ve, Gg, Gg, Gg, Gg, Gg^Efm, Gg, Gs^Fms, Cv, Gs, Gg, Gg, Cv, Gs^Fms, Gs^Fds, Gs^Fds, Gs^Fds, Gs^Fms, Gs^Fms, Gs, Gs^Fds, Gg^Ve, Gs^Fms
Hh, Hh, Hh, Gs^Fds, Gs^Fds, Gs^Fds, Gs^Fds, Gg, Gg, Cv, 1 Kv, Cv, Rp, Cv, 2 Kv, Cv, Gs^Fms, Gs^Fds, Gs^Fds, Gs^Fms, Gs, Gs, Gs^Fds, Gs^Fds, Gs^Fds
Gs^Fds, Gs^Fms, Gs^Fms, Gg^Fet, Gs^Fds, Gs^Fds, Gs^Fms, Gs^Fds, Gs^Fds, Gs^Fms, Gs^Fds, Rp, Rp, Rp, Gs^Fds, Gs^Fds, Gs^Fds, Gs^Fms, Gs^Fds, Gg, Gs^Fms, Gs^Fds, Gs^Fms, Gs^Fds, Gs^Fds
Gs^Fds, Gs^Fms, Gs^Fms, Gs^Fds, Gs^Fms, Gs^Fms, Gs^Fds, Gs^Fds, Gs^Fms, Gs^Fms, Gg, Gg, Rp, Gg, Gs^Fds, Gs^Fds, Gs^Fds, Gs^Fds, Gg, Gg, Gs^Fds, Gs^Fms, Gs^Fds, Gs^Fds, Gs^Fds
