Gs^Fds, Gs^Fms, Gs^Fds, Gs^Fds, Gs^Fms, Gs^Fds, Gs^Fdw, Gs^Fds, Re, Re, Re, Rb, Re, Gs^Fds, Gs^Fds, Gs^Fds, Gs^Fds, Gs^Fms, Hh, Hh, Hh, Hh
Gs^Fds, Gs^Fds, Gs^Fms, Gs^Fds, Gs^Fds, Gs^Fdw, Rb^Qov, Re, Rb^Es, Re, Ce^Es, Rb, Re, Rb^Es, Re, Gs^Fds, Gs^Fds, Gs^Fds, Gs^Fds, Hh, Mm, Mm
Gs^Fds, Gs^Fds, Gs^Fds, Gg^Fet, Gs^Fds, Gs^Fds, Gs^Fdw, Rb^Es, Rb, Ce, 3 Ke, Ce^Es, Rb, Re, Gs^Fds, Gs^Es, Gs^Fds, Gg^Fet, Gs^Fds, Hh, Hh, Mm
Gs^Fms, Gs^Fds, Gs^Fds, Gs^Fds, Gs^Fms, Rb^Qov, Re, Re, Re^Es, Ce^Es, Ce^Es, Ce, Re^Es, Re, Gs^Fdw, Gs^Fds, Gs^Fds, Gs^Fms, Hh, Hh, Gs^Fds, Hh
Gs^Fds, Gs^Fds, Gs^Fds, Gg^Ve, Gg, Re, Gs, Re^Es, Re^Es, Re, Rb, Re, Re^Es, Re, Re, Gg^Ve, Gs^Fds, Gs^Fms, Gs^Fms, Gs^Fds, Gs^Fds, Gs^Fds
Gs^Fds, Gs^Fds, Gs^Fms, Gs^Fds, Gg, Gs, Gs^Fdw, Gs^Fds, Re, Rb, Rb^Qov, Rb^Es, Gs^Fdw, Gs^Fds, Gs^Fds, Gs^Fds, Hh, Hh, Gs^Fds, Hh, Hh, Hh
Gs^Fds, Gs^Fds, Gs^Fds, Gg, Gg, Gs, Gs^Fds, Gs^Fds, Gs^Fds, Gs^Fdw, Gs, Re, Re, Gs^Fds, Gg^Fet, Gs^Fds, Gs^Fds, Gs^Fms, Gs^Fds, Hh, Gs^Fds, Gs^Fms
Gs^Fms, Gs^Fds, Gs, Gs, Gs^Fms, Gs^Fds, Hh, Hh, Gg^Ve, Gs, Gs^Fdw, Gs, Gg, Gs^Fds, Gs^Fms, Gs^Fds, Gg, Gs^Fds, Gs^Fds, Gs^Fds, Gs^Fds, Gs^Fds
Gs^Fds, Gs, Gs, Gg^Efm, Gs^Fds, Gs^Fds, Hh, Gs^Fms, Hh, Gs^Fds, Gs^Fds, Gg, Gg^Efm, Gg, Gg, Gg^Ve, Gg, Gs^Fms, Gs^Fds, Ds, Ww, Gs^Fds
Gs^Fds, Gs^Fds, Gg^Efm, Gg, Gg, Gs^Fms, Gs^Fds, Gg^Fet, Gs^Fds, Gs^Fds, Gs^Fds, Gs^Fds, Gs^Fds, Gg^Efm, Gs, Gg, Gg, Ds, Gs^Fds, Ds, Ww, Ww
Hh^Fms, Gs^Fds, Gs^Fms, Gg, Gg, Gs^Fds, Gs^Fds, Gs^Fds, Gg^Em, Gs^Fms, Gg, Gg^Efm, Gs, Gg, Gs, Gg^Efm, Gg, Gs^Fms, Gs^Fms, Ww, Ww, Ww
Gs^Fms, Gs^Fds, Gg, Gg, Gg, Gg, Gs, Gs, Gg, Gg, Gg, Gs, Gs^Fms, Gs, Gs^Fms, Gg, Gs, Gs^Fds, Ww, Ww, Ww, Ww
Gs^Fms, Gg, Gg^Ve, Gg, Gg, Gg^Efm, Gg^Efm, Gg^Efm, Gs^Fds, Gs^Fds, Gs^Fds, Gs^Fds, Gs^Fds, Gs^Fms, Gs^Fds, Gs^Fds, Gs, Ds, Gg^Ve, Gs^Fds, Gs^Fds, Ww
Gs^Fds, Gs^Fds, Gs^Fms, Gs^Fds, Gs^Fds, Gs^Fds, Gs^Fds, Gs^Fds, Gs^Fds, Gs^Fms, Gs^Fds, Gg, Gs^Fds, Gs^Fds, Gg^Efm, Gg, Gg, Ds, Gs^Fds, Gs^Fds, Gs^Fds, Gs^Fds
Gs^Fds, Gs^Fms, Gs^Fds, Gs^Fms, Gs^Fds, Gs^Fms, Gg^Em, Gg, Gg, Gg^Efm, Gg^Fet, Gs^Fds, Gs^Fms, Gg^Efm, Gg, Gg, Gs^Fds, Gg, Gs^Fds, Gs^Fds, Gs^Fds, Gs^Fds
Gs^Fms, Gs^Fms, Gg, Gg^Efm, Gs^Fds, Gs^Fds, Gs^Fds, Gs^Fds, Gg, Gs^Fds, Gs^Fds, Gs^Fms, Gs^Fds, Gs, Gg, Gg^Ve, Gs^Fds, Gs^Fds, Gg^Efm, Gs^Fms, Gs^Fds, Gs^Fms
Hh, Hh, Hh, Hh, Hh, Gg^Ve, Gs^Fms, Gs^Fms, Gs^Fms, Gs^Fds, Gs^Fms, Gg^Efm, Gs, Gs, Gg^Efm, Gs^Fms, Gs^Fds, Gg, Gs^Fds, Gs^Fds, Gs^Fds, Gs^Fds
Hh, Hh, Gs^Fms, Hh, Gs^Fds, Gs^Fds, Gs^Fms, Gs^Fds, Gs^Fms, Gs^Fds, Gg, Gs, Gs, Gg, Gs^Fds, Gg, Gs^Fms, Gs^Fds, Gs^Fds, Gg^Fet, Gs^Fds, Gs^Fms
Hh, Hh, Hh, Gs^Fms, Gg^Fet, Gs^Fds, Gs^Fds, Gs^Fds, Cv, Gg, Gg, Gg, Cv, Gs^Fds, Gs^Fds, Gs^Fds, Gs^Fms, Gs^Fds, Gs^Fms, Gs^Fds, Gs^Fms, Gs^Fms
Hh, Hh, Gs^Fds, Gs^Fds, Gs^Fds, Gs^Fds, Gs^Fds, Cv, 1 Kv, Cv, Rp, Cv, 2 Kv, Cv, Gs^Fms, Gs^Fds, Gs^Fds, Gs^Fds, Gg^Ve, Gs^Fms, Gs^Fds, Gs^Fds
Hh, Hh, Hh, Gg^Ve, Gs^Fds, Gs^Fds, Gs^Fds, Gs^Fds, Gs^Fds, Gs^Fds, Rp, Gs^Fms, Gs^Fds, Gs^Fds, Gs^Fms, Gg^Fet, Gs^Fds, Gs^Fds, Gs^Fds, Gs^Fms, Gs^Fms, Gs^Fms
Hh, Hh, Hh, Hh, Gs^Fds, Gs^Fds, Gs^Fms, Gs^Fms, Gs^Fds, Gs^Fds, Rp, Gs^Fds, Gs^Fms, Gs^Fms, Gs^Fds, Gs^Fds, Gs^Fds, Gs^Fds, Gs^Fds, Gs^Fds, Gs^Fms, Gs^Fds
