Hh, Hh, Gs, Rb, Re, Gs, Gs, Gs, Gs, Gs, Gs, Gs, Ww, Gs^Fds, Hh, Hh, Hh, Hh, Hhd, Gs^Fds, Gs^Fms, Gs^Fms
Hh, Hh, Gs, Rb, Re, Re^Es, Re, Co, Co, Gs, Gs, Ww, Hh, Hh, Hh, Hh, Hhd, Hhd, Gs^Fms, Gs^Fms, Gs^Fms, Gs^Fms
Hh, Hh, Gs, Re^Es, Co, Co, Co, Re, Re^Vo, Co, Ww, Ww, Gs, Hh, Hh, Gs^Fms, Gs^Fds, Hhd, Gs, Re^Vo, Hh, Gs^Fms
Gs, Gs, Co, Rb^Es, Co, 3 Ko, Co, Re, Re, Rb, Ww, Gs, Gs^Fdw, Gs^Fdw, Gs^Fms, Gg^Fet, Gs^Fms, Gs^Fms, Gs^Fms, Gs, Gs, Hh
Gs, Gs, Co, Rb, Re^Es, Co, Rb^Edt, Rb^Es, Re^Es, Co, Ww, Gs, Gs, Re^Vo, Gs, Gs^Fms, Re^Es, Re^Es, Re, Gs, Hh, Hh
Gs^Fdw, Gs, Co, Re^Vo, Re, Re^Es, Rb, Re^Es, Co, Co, Ww, Gs, Gs^Fdw, Gs, Hh, Re, Hhd, Hhd, Re^Vo, Hh, Gs^Fms, Gs^Fms
Gs^Fdw, Gs, Gs, Re, Co, Re^Es, Co, Re, Ww^Bw\, Ww, Re^Es, Gs, Gs^Fdw, Gs^Fp, Hh, Hh, Gs^Fds, Gs^Fms, Gs, Gs^Fds, Ww, Ww
Gs^Fms, Gs^Fdw, Ww, Ww, Ww, Co, Ww, Ww, Re^Es, Rb^Edt, Rb^Es, Re, Re, Gs^Fp, Gs^Fms, Gs^Fdw, Ww, Ww, Ww, Ww, Gs^Fds, Gs^Fds
Ww, Ww, Gs, Gs, Gs, Ww, Re, Re, Gs^Fdw, Re, Co, Rb^Es, Co, Gs^Fdw, Ww, Ww, Gs^Fds, Gs^Fds, Gs^Fp, Gs^Fds, Gs^Fds, Gs^Fms
Gs^Fms, Gs, Gs, Hh, Hh, Rb^Es, Re^Vo, Gs^Fdw, Gs, Gs, Ww, Ww^Bw|, Ww, Ww, Gs^Fms, Gs^Fds, Gs^Fp, Gs^Fms, Gs, Gs^Fms, Gs^Fds, Gs^Fds
Gs^Fds, Gs^Fms, Hh, Hh, Rb, Rb, Gs, Gs^Fdw, Ww, Ww, Gs^Fms, Re^Edt, Re, Gs^Fms, Hh, Hh, Hh, Hhd, Hhd, Hh, Gs^Fp, Gs^Fds
Gs^Fms, Gs^Fms, Re^Vo, Re^Es, Gs^Fds, Gs^Fds, Gs^Fms, Ww, Gs^Fms, Gs^Fms, Hh, Rb, Re^Es, Gs^Fms, Gs, Re^Vo, Gs^Fms, Gs, Hh, Gs^Fms, Gs^Fms, Gs^Fds
Hh, Hhd, Re, Re^Es, Gs, Gg^Fet, Gs^Fms, Ww, Gs^Fp, Hh, Re^Vo, Rb, Rb^Es, Re^Edt, Re, Gs^Fms, Gs, Gs^Fds, Gs^Fms, Gg^Fet, Gs^Fms, Gs^Fms
Hh, Hhd, Rb, Gs^Fdw, Gs^Fms, Gs^Fms, Ww, Ww, Gs^Fp, Gs, Gs^Fp, Gs, Gs^Fp, Rb^Es, Re, Rb^Es, Gs^Fms, Hh, Hh, Gs^Fds, Gs^Fms, Gs^Fds
Hh, Rb, Gs, Gs^Fms, Ww, Ww, Gs^Fms, Gs^Fds, Gs^Fms, Gs, Gs^Fms, Gs, Ww, Gs^Fp, Ww, Rb, Ww, Gs^Fms, Gs^Fms, Gs^Fms, Ww, Ww
Hh, Rb^Es, Re, Re^Vo, Ww, Gs^Fds, Ww, Ww, Ww, Gs^Fms, Ww, Ww, Gs^Fds, Ww, Re, Ww, Gs^Fms, Ww, Ww, Ww, Gs^Fms, Gs^Fms
Gs^Fds, Hh, Gs^Fds, Re, Ww, Ww, Gs^Fds, Gs^Fds, Gs^Fms, Ww, Gs^Fms, Gs^Fms, Gg^Fet, Gs^Fms, Re^Es, Rb, Gs^Fds, Gs^Fds, Gs^Fms, Gs^Fds, Gs^Fds, Gs^Fds
Gs^Fds, Gs^Fds, Gs^Fds, Gs^Fds, Ww, Ww, Rb, Gs^Fds, Gs, Gs^Fms, Gs^Fms, Gs^Fms, Gs^Fms, Gs^Fds, Re^Es, Rb^Edt, Re, Gs^Vc, Gs^Fms, Gs^Fms, Gs^Fms, Gs^Fds
Hh, Hh, Ww, Ww, Ww, Ww, Gs, Rb, Rb^Es, Rb^Es, Re, Gs^Vc, Re, Re, Gs, Rb, Re^Es, Gs^Fds, Ce, Gs^Fds, Gs^Fds, Gs^Fds
Hh, Hh, Wo, Ww, Ww, Gs^Fms, Gs^Fms, Gs^Fds, Gs^Fds, Gs^Fms, Gs^Fms, Re, Ce, Ce, Ce, Rb, Re^Es, Ce, 2 Ke, Ce, Gs^Fms, Gs^Fds
Wo, Wo, Wo, Wo, Ww, Gs^Fms, Gg^Fet, Gs^Fms, Gs^Fms, Gs^Fms, Gs^Fms, Gs^Fms, Gs^Fds, 1 Ke, Gs^Fds, Gs^Fms, Re, Rb, Gs, Gs^Fms, Gs^Fds, Gs^Fds
Wo, Wo, Ww, Ww, Gs^Fds, Gs^Fms, Gs^Fms, Gs^Fms, Gs^Fms, Gs^Fms, Gs^Fms, Gs^Fms, Gs^Fms, Gs^Fds, Gs^Fms, Gs^Fms, Re, Rb^Es, Gs, Gs^Fds, Gs^Fms, Gs^Fms
