Mm, Mm, Hh, Hh^Fds, Gs^Fms, Hh^Fds, Hh, Hh, Gs, Hh, Hh, Gs, Gs^Fms, Ww, Gg, Gs^Fms, Gs^Fms, Hh^Fds, Gg, Hh^Fds, Mm, Mm
Mm, Mm, Hh, Hh, Gs^Fdw, Hh, Hhd, Hhd, Rb^Vo, Hhd, Hhd, Gs^Es, Gs^Fdw, Ww, Gg, Gs^Fds, Gs^Fms, Hh, Gd^Vo, Hh, Mm, Mm
Hh, Hh, Gs^Fms, Gs^Fds, Rb^Vo, Gs^Fds, Gs^Es, Hhd, Re^Es, Rb, Re, Gs^Fms, Re, Ww, Ww, Gg, Gs^Fds, Gs^Fms, Re^Es, Hh, Hh, Hh
Hh, Hh, Hh, Gs^Fms, Gs, Rb, Co^Es, Rb, Rb, Hhd, Hh, Re^Es, Hh, Gs, Gs, Ww, Gs, Gs, Gs^Fds, Re, Hh, Hh^Fds
Mm, Mm, Hh, Gs^Fdw, Re, Co^Es, 3 Ko^Es, Co^Es, Re, Gs^Fetd, Hh, Hh, Hh^Fds, Hh, Gs^Fds, Ww, Gd^Vo, Re, Gs^Fds, Gg, Gs^Fms, Gs^Fms
Hh, Hh, Gs^Fds, Gs^Es, Gs^Es, Co^Es, Co^Es, Co^Es, Gs^Es, Gs^Es, Hh, Mm, Hh, Gs^Fms, Ww, Ww, Gs^Fms, Re, Re, Gg, Gs^Fds, Gs^Fms
Hh, Hh, Hh, Gs^Fdw, Rb, Rb, Re, Rb^Es, Hh, Hh, Hh, Hh, Gs, Gs^Fms, Mm, Gs^Fds, Hh, Gs^Fds, Re^Es, Gd^Vo, Gs^Fms, Gs^Fms
Hh^Fds, Hh, Gs^Fdw, Hh, Rb^Es, Gs^Fms, Gs^Fdw, Rb, Rb, Gs^Fms, Gs, Gs, Ww, Ww, Hh, Hh, Hh^Fds, Gs^Fms, Gs^Fds, Re^Es, Gs^Fds, Gs^Fds
Gs^Fms, Gs^Fms, Ww, Gs^Fms, Rb, Gs^Es, Gd^Vo, Gs^Fms, Hh, Rb, Rb, Gs^Fms, Ww, Gs^Fms, Gs^Fms, Gs^Fds, Gs^Fms, Gd^Vo, Gg, Re, Ww, Gs^Fms
Ww, Ww, Rb, Wwf, Ww, Gs^Fms, Gs^Fms, Hh, Hh, Hh, Rb, Gs^Fds, Ww, Gs^Fds, Ww, Ww, Ww, Gs^Fms, Ww, Ww, Gs^Fds, Ww
Gs^Fds, Gs^Fms, Rb, Gs^Vo, Hh, Ww, Ww, Gs^Fds, Gs^Fms, Gs, Ww, Ww, Ww, Ww, Hh, Hh, Gs^Fms, Ww, Re, Re, Gs^Fms, Gs^Fds
Gs^Fds, Gs^Fds, Gs^Fms, Rb, Hh, Gs^Fds, Ww, Gs^Fms, Ww, Ww, Hh, Re, Gs^Vc, Gs^Fds, Hh, Hh, Gs^Fds, Gs^Fms, Re, Gs^Fds, Ww, Gs^Fds
Re, Re, Re, Rb, Re, Gs^Fms, Gs^Fds, Ww, Gs^Fds, Hh, Hh, Re, Re, Hh, Gs^Fds, Gs^Fms, Ww, Ww, Ww, Ww, Gs^Fds, Ww
Hh^Fds, Hh, Hh, Gs^Fms, Gg, Gs^Fms, Gs^Fms, Ww, Gs^Fms, Gs^Fds, Ww, Ww, Ww, Re, Ww, Ww, Gs^Fds, Gs^Fds, Gs^Fds, Gs^Fds, Gs^Fds, Gs^Fds
Mm, Mm, Hh, Gg^Vc, Hh, Gg^Efm, Gs^Fds, Ww, Ww, Ww, Gs^Fds, Gs^Fds, Gs^Fds, Ww, Re, Gs^Fds, Gs^Fds, Gs^Fds, Re, Gs^Fds, Gs^Fms, Gs^Fds
Mm, Mm, Hh, Hh, Hh, Gg^Efm, Ww, Ww, Ww, Gs^Fds, Gs^Vc, Gs^Fds, Gs^Fms, Gs^Fds, Re, Gs^Fds, Gg^Efm, Gs^Fms, Gs^Fds, Gs^Fds, Gs^Fds, Gs^Fds
Hh, Hh, Gg, Hh, Gg, Gg, Ww, Ww, Gs^Fms, Gs^Fds, Gg, Gg, Gs^Fds, Gs^Fds, Gs^Fds, Gs^Fds, Re, Gs^Fms, Gs^Fds, Gg^Fet, Gs^Fds, Gs^Fds
Hh, Hh, Ww, Gs^Fds, Ww, Ww, Ww, Ww, Gs^Fms, Gs^Fms, Gg, Gs^Fds, Gg^Fet, Gs^Fds, Gs^Fds, Gg^Vc, Gs^Fds, Re, Gs^Fds, Gs^Fds, Gs^Fds, Gg
Ww, Ww, Wo, Ww, Ww, Ww, Gg, Gg^Efm, Gs^Fds, Gs^Fds, Gs^Fds, Gg^Efm, Gs^Fds, Gs^Fds, Gg^Fet, Gs^Fds, Gs^Fds, Gg^Efm, Gg, Gg, Gg^Efm, Gg^Efm
Wo, Wo, Wo, Wo, Ww, Gs^Fds, Gs^Fet, Gs^Fds, Gs^Fds, Gs^Fds, Gs^Fds, Gg, Ce, Ce, Ce, Re, Ce, Ce, Ce, Hh, Hh, Hh
Wo, Wo, Wo, Wo, Ww, Gg, Gs^Fds, Gs^Fds, Gg, Gg, Gs^Fds, Gs^Fds, Gs^Fds, 1 Ke, Gs^Fds, Re, Re, 2 Ke, Hh, Hh, Hh, Hh
Wo, Wo, Wo, Wo, Ww, Gg, Gs^Fds, Gs^Fds, Gg, Gs^Fds, Gs^Fds, Gs^Fds, Gs^Fds, Gs^Fds, Gs^Fds, Gs^Fds, Re, Hh, Hh, Hh, Hh, Hh
