Xu, Xu, Rb, Xu, Xu, Xu, Xu, Xu, Xu, Xu, Xu, Xu, Xu, Xu, Xu, Xu, Xu, Xu, Xu, Xu, Xu, Xu
Xu, Xu, Rb^Ii, Xu, Xu, Uu, Uu, Xu, Uu, Uu, Xu, Uu, Uu^Es, Xu, Uu^Es, Uu, Xu, Xu, Uu^Es, Xu, Xu, Xu
Xu, Xu, Uu^Es, Xu, Uu, Uu^Pr\, Xu, Xu, Xu, Uu^Pr/, Rb, Uu^Pr\, Xu, Xu, Xu, Uu^Pr/, Uu, Uh^Es, Xu, Rb^Es, Xu, Xu
Xu, Xu, Xu, Rb^Es, Rb^Es, Xu, Uu^Es, Rb^Es, Rb, Uu^Es, Rb^Es, Uu, Uh, Xu, Rb^Es, Rb^Es, Xu, Xu, Xu, Uu^Pr/, Xu, Xu
Xu, Uu, Uu, Uu^Pr\, Xu, Uu^Es, Xu, Uh, Rb, Uu^Es, Uu^Es, Uu^Dr, Uu, Uu, Xu, Uu^Pr/, Uu^Es, Xu, Uu^Es, Uu, Uu, Xu
Xu, Xu, Xu, Xu, Xu, Xu, Xu, Xu, Xu, Xu, Xu, Xu, Xu, Xu, Xu, Xu, Xu, Xu, Xu, Xu, Xu, Xu
_f^_s, _f^_s, _f^_s, _f^_s, _f^_s, _f^_s, _f^_s, _f^_s, _f^_s, _f^_s, _f^_s, _f^_s, _f^_s, _f^_s, _f^_s, _f^_s, _f^_s, _f^_s, _f^_s, _f^_s, _f^_s, _f^_s
Mm, Mm, Hh, Hh^Fds, Gs^Fms, Hh^Fds, Hh, Hh, Gs, Hh, Hh, Gs, Gs^Fms, Ww, Gg, Gs^Fms, Gs^Fms, Hh^Fds, Gg, Hh^Fds, Mm, Mm
Mm, Mm, Hh, Hh, Gs^Fdw, Hh, Hhd, Hhd, Rb^Vo, Hhd, Hhd, Gs^Es, Gs^Fdw, Ww, Gg, Gs^Fds, Gs^Fms, Hh, Gd^Vo, Hh, Mm, Mm
Hh, Hh, Gs^Fms, Gs^Fds, Rb^Vo, Gs^Fds, Gs^Es, Hhd, Re^Es, Rb, Re, Gs^Fms, Re, Ww, Ww, Gg, Gs^Fds, Gs^Fms, Gg, Hh, Hh, Hh
Hh, Hh, Hh, Gs^Fms, Gs, Rb, Co, Rb, Rb, Hhd, Hh, Re^Es, Hh, Gs, Gs, Ww, Gs, Gs, Gs^Fds, Gg, Hh, Hh^Fds
Mm, Mm, Hh, Gs^Fdw, Re, Co, 3 Ko, Co^Es, Re, Gs^Fdw, Hh, Hh, Hh^Fds, Hh, Gs^Fds, Ww, Gs, Gs, Gs^Fds, Gg, Gs^Fms, Gs^Fms
Hh, Hh, Gs^Fds, Gs^Es, Gs^Es, Co, Co, Co, Gs^Es, Gs^Es, Hh, Mm, Hh, Gs^Fms, Ww, Ww, Gs^Fms, Gs, Gg, Gg, Gs^Fds, Gs^Fms
Hh, Hh, Hh, Gs^Fdw, Rb, Rb, Re, Rb^Es, Hh, Hh, Hh, Hh, Gs, Gs^Fms, Ww, Gs^Fds, Hh, Gs^Fds, Gg, Gs^Fms, Gs^Fms, Gs^Fms
Hh^Fds, Hh, Gs^Fdw, Hh, Rb^Es, Gs^Fms, Gs^Fdw, Rb, Rb, Gs^Fms, Gs, Gs, Ww, Ww, Hh, Hh, Hh^Fds, Gs^Fms, Gs^Fds, Gg, Gs^Fds, Gs^Fds
Gs^Fms, Gs^Fms, Ww, Gs^Fms, Rb, Gs^Es, Gd^Vo, Gs^Fms, Hh, Rb, Rb, Gs^Fms, Ww, Gs^Fms, Gs^Fms, Gs^Fds, Gs^Fms, Gd^Vo, Gg, Gg, Gs^Fms, Gs^Fms
Ww, Ww, Rb, Wwf, Ww, Gs^Fms, Gs^Fms, Hh, Hh, Hh, Rb, Gs^Fds, Ww, Gs^Fds, Ww, Ww, Ww, Gs^Fms, Gg, Gs^Fds, Ww, Ww
Gs^Fds, Gs^Fms, Rb, Hh, Hh, Ww, Ww, Gs^Fds, Gs^Fms, Gs, Ww, Ww, Ww, Ww, Hh, Hh, Gs^Fms, Ww, Ww, Ww, Gs^Fms, Gs^Fds
Gs^Fds, Gs^Fds, Gs^Fms, Rb, Hh, Gs^Fds, Ww, Gs^Fms, Ww, Ww, Hh, Gg, Gs^Fms, Gs^Fds, Hh, Hh, Gs^Fds, Gs^Fms, Gg, Gs^Fds, Gs^Fds, Gs^Fds
Gs^Fds, Gs^Fds, Gs^Fds, Rb, Gg, Gs^Fms, Gs^Fds, Ww, Gs^Fds, Hh, Hh, Gg, Hh, Hh, Gs^Fds, Gs^Fms, Gg, Gg, Gs^Fms, Gg^Vc, Gs^Fds, Gs^Fds
Hh^Fds, Hh, Hh, Gs^Fms, Gg, Gs^Fms, Gs^Fms, Ww, Gs^Fms, Gs^Fds, Gs^Fms, Gg, Gg, Gg, Gg^Efm, Gs^Fms, Gg, Gs^Fds, Gg^Fet, Gs^Fds, Ww, Ww
Mm, Mm, Hh, Gg^Vc, Hh, Gg^Efm, Gs^Fds, Ww, Gs^Fds, Gg^Fet, Gg^Vc, Gs^Fds, Gs^Fms, Gs^Fds, Gs^Fds, Gg, Ww, Ww, Ww, Ww, Gs^Fds, Gs^Fds
Mm, Mm, Hh, Hh, Hh, Gg^Efm, Ww, Ww, Ww, Gg, Ww, Ww, Ww, Gs^Fds, Ww, Ww, Gg^Efm, Gs^Fds, Gs^Fds, Gs^Fds, Gs^Fds, Gs^Fds
Hh, Hh, Gg, Hh, Gg, Gg, Ww, Ww, Gs^Fms, Ww, Gg, Gg, Gs^Fds, Ww, Gs^Fds, Gs^Fds, Gg, Gs^Fds, Gs^Fds, Gg^Fet, Gs^Fds, Gs^Fds
Hh, Hh, Ww, Gs^Fds, Ww, Ww, Ww, Ww, Gs^Fms, Gs^Fms, Gg, Gs^Fds, Gg^Fet, Gs^Fds, Gs^Fds, Gg^Vc, Gs^Fds, Gg, Gs^Fds, Gs^Fds, Gg^Vc, Gg
Ww, Ww, Wo, Ww, Ww, Ww, Gg, Gg^Efm, Gs^Fds, Gs^Fds, Hh, Gg^Efm, Gs^Fds, Gs^Fds, Gg^Fet, Gs^Fds, Gs^Fds, Gg^Efm, Gg, Gg, Gg^Efm, Gg^Efm
Wo, Wo, Wo, Wo, Ww, Gs^Fds, Gs^Fds, Gg^Vc, Gg, Hh^Fds, Hh, Gg, Gg, Gs^Fds, Gs^Fds, Ce, Ce, Gs^Fds, Ce, Ce, Gs^Fds, Gs^Fds
Wo, Wo, Wo, Wo, Ww, Gg, Gs^Fds, Gs^Fds, Hh, Hh, Hh, Hh, Gg, Gs^Fds, Gs^Fds, 1 Ke, Gs^Fds, Gs^Fds, Gs^Fds, 2 Ke, Gs^Fds, Gs^Fds
Wo, Wo, Wo, Wo, Ww, Gg, Gs^Fds, Gs^Fds, Hh^Fds, Hh, Hh, Hh, Gg, Gs^Fds, Gs^Fds, Gs^Fds, Gs^Fds, Gs^Fds, Gs^Fds, Gs^Fds, Gs^Fds, Gs^Fds
