Mm, Mm, Mm, Hhd, Hhd, Hhd, Hhd, Re, Rb, Rb, Rb, Re, Re, Re, Re, Re, Rb, Rb, Rb, Rb, Rb, Re
Mm, 3 Mm, Mm, Hhd, Hhd, Hhd, Re, Re, Re, Rb, Re, Re^Es, Re, Re, Hh, Rb, Re, Rb^Es, Rb, Re, Re, Re
Hhd, Mm, Hhd, Hhd, Hhd, Mm, Re, Re, Rb^Es, Re^Es, Re, Hh, Hh, Hh, Hhd, Rb, Hhd, Rb^Es, Rb^Es, Ss, Hhd, Hhd
Hhd, Hhd, Hh, Hhd, Re, Mm, Hh, Re, Rb^Es, Re^Es, Re^Es, Re, Hh, Mm, Mm, Hhd, Hhd, Rb, Rb^Es, Ss, Hhd, Hhd
Mm, Hh, Hh, Re, Re, Re, Re^Es, Re, Rb^Es, Rb, Re^Es, Re, Hhd, Hhd, Gd^Fmw, Hhd, Gd^Fmw, Re, Rb^Es, Hhd, Re, Hhd
Hh, Mm, Re, Hh, Re, Re^Es, Rb, Rb^Es, Rb, Gd^Fmw, Rb, Re, Re, Re, Gd^Fdw, Gd^Fmw, Re^Es, Re^Es, Re, Re, Re^Es, Hhd^Es
Rb, Hh, Re^Es, Re^Es, Re, Rb^Es, Re, Rb, Gd^Fmw, Gd^Fdw, Gd^Fmw, Rb, Rb, Re^Es, Re, Gd^Fmw, Re, Re, Gd^Fmw, Gd^Fmw, Re, Re
Rb, Re, Rb, Re, Re, Rb, Re, Ss, Gd^Fmw, Gd^Fmw, Rb, Gd^Fmw, Re, Re^Es, Re^Es, Re, Re, Rb, Gd^Fmw, Gd^Fdw, Gd^Fmw, Re
Gd^Fdw, Rb, Gd^Fdw, Gd^Fdw, Ss, Re, Re, Re, Re^Es, Rb^Es, Rb^Es, Rb, Re, Re, Gd^Fmw, Re, Gd^Fmw, Rb, Rb, Gd^Fmw, Re, Re
Gd^Fdw, Gd^Fdw, Gd^Fmw, Gd^Fmw, Ss, Re, Re, Re^Es, Rb^Es, Rb^Es, Re^Es, Rb, Rb, Re, Gd^Fmw, Gd^Fdw, Re, Rb, Re, Rb, Re, Re
Gd^Fdw, Gd^Fdw, Gd^Fdw, Gd^Fdw, Gd^Fp, Re, Re, Rb^Es, Re, Re, Gd^Fdw, Re, Re, Re, Re, Gd^Fmw, Re, Re, Ce, Rb, Rb, Re
Rb, Gd^Fmw, Rb, Rb, Rb, Re, Rb, Re, Re, Gd^Fmw, Gd^Fmw, Gd^Fmw, Gd^Fmw, Re^Es, Re^Es, Re, Re, Ce, 1 Ke, Ce, Rb, Rb
Rb, Rb, Re, Rb, Re, Rb, Re^Es, Re^Es, Re, Gd^Fmw, Rb, Rb, Rb^Es, Re, Rb, Rb, Rb, Ce, 2 Ce, Ce, Rb, Rb
Rb, Re, Rb, Gd^Fmw, Re, Re, Re, Re, Re, Re^Es, Rb^Es, Re^Es, Rb, Rb^Es, Gd^Fmw, Re, Re, Re, Re, Re, Rb^Es, Re^Es
Rb, Rb, Re, Gd^Fdw, Gd^Fdw, Gd^Fdw, Gd^Fmw, Rb, Rb, Re^Es, Re, Re, Gd^Fmw, Re, Re, Gd^Fmw, Re^Es, Re, Gs^Fp, Re, Re, Re^Es
Ss, Rb, Re, Gd^Fmw, Re, Gd^Fmw, Re, Rb^Es, Rb, Re, Re, Re, Gd^Fmw, Gd^Fmw, Re, Re, Re, Re, Gs^Fp, Gs^Fp, Gs^Fp, Re
Ss, Re, Re, Re, Re, Re, Rb^Es, Rb^Es, Rb^Es, Re, Re, Gd^Fmw, Gd^Fp, Gd^Fp, Gd^Fmw, Re, Re, Gs^Fp, Re, Gs^Fp, Re, Gs^Fp
Hh, Re, Hh, Ss, Re, Rb, Re^Es, Rb, Re, Rb^Es, Rb, Gd^Fmw, Re, Re, Re^Es, Re^Es, Re^Es, Re, Rb, Rb, Rb^Es, Rb
Hh, Hh, Hh, Ss, Ss, Re^Es, Re, Re, Gs^Fmw, Re, Re, Rb, Re, Re^Es, Re^Es, Rb^Es, Re, Re, Re^Es, Re^Es, Re, Re^Es
Hh, Hh, Gs, Hh, Re, Re, Gs^Fmw, Re, Gs^Fp, Gs^Fp, Gs^Fmw, Re, Re, Re^Es, Rb^Es, Rb^Es, Gs^Fp, Re, Gs^Fp, Gs^Fp, Re, Re
Hh, Hh, Gs, Gs, Hh, Ss, Gs^Fmw, Gs^Fp, Gs^Fp, Gs^Fmw, Hh, Hh, Re, Rb^Es, Rb, Rb, Gs^Fp, Gs^Fp, Gs^Fp, Gs^Fp, Gs^Fp, Gs^Fp
Gs, Gs, Hh, Hh, Hh, Ss, Gs^Fmw, Gs^Fmw, Gs^Fp, Gs^Fmw, Gs^Fmw, Gs^Fp, Hh, Re, Rb, Rb, Gs^Fp, Gs^Fp, Gs^Fp, Gs^Fp, Gs^Fp, Gs^Fp
