Ms, Ms, Ms, Ms, Ms, Hhd, Hhd, Hhd, Re, Re, Rb, Re, Re^Es, Re, Rb^Es, Re, Re, Re, Re, Re, Rb, Re, Hhd, Hhd, Hhd, Hhd, Hhd
Ms, Mm, 3 Mm, Ms, Ms, Ms, Hhd, Hhd, Rb, Re, Rb^Es, Re^Es, Rb, Rb^Es, Rb, Re^Es, Re^Es, Rb, Rb, Re, Hhd, Re, Hhd, Hhd, Hhd, Hhd, Hhd
Ms, Ms, Mm, Mm, Mm, Hhd, Hhd, Hhd, Re, Re^Es, Re, Re, Rb, Hhd, Rb, Rb, Re^Es, Re, Re, Hhd, Hhd, Hhd, Hh, Hh, Hh, Hhd, Hhd
Ms, Ms, Ms, Mm, Mm, Hhd, Hhd, Re, Re, Rb, Hhd, Hhd, Hhd, Hhd, Hh, Hhd, Rb^Es, Re^Es, Re, Hhd, Re^Es, Hhd, Hh, Hh, Hh, Hhd, Hhd
Hhd, Hhd, Hhd, Hhd, Hhd, Hhd, Hhd, Re, Rb, Re, Re^Es, Hhd, Hh, Hh, Hh, Hhd, Re, Re^Es, Rb^Es, Re, Re^Es, Re^Es, Hh, Hh, Hh, Hhd, Hh
Hhd, Hhd, Re, Hhd, Re, Hhd, Rb, Hhd, Re^Es, Re^Es, Re^Es, Re, Rb, Hh, Re, Hh, Gd^Fdw, Re, Re, Gd^Fdw, Re, Re, Rb^Es, Re, Hh, Hh, Re
Rb, Hhd, Re^Es, Re^Es, Re^Es, Re, Rb^Es, Rb^Es, Rb, Re, Re^Es, Rb, Re, Re, Re, Re, Gd^Fmw, Re, Gd^Fmw, Gd^Fdw, Rb, Rb, Rb, Re, Re, Re, Re^Es
Rb, Re, Re^Es, Re^Es, Re^Es, Re^Es, Re, Hhd, Hh, Hh, Hh, Re^Es, Rb^Es, Rb^Es, Re, Re, Gd^Fmw, Gd^Fdw, Gd^Fmw, Gd^Fmw, Gd^Fdw, Rb, Re, Re^Es, Re^Es, Rb^Es, Re
Re, Re, Re, Re^Es, Re, Rb, Hhd, Hhd, Hh, Hh, Hh, Re, Re, Re, Re, Rb, Gd^Fmw, Gd^Fmw, Re, Gd^Fmw, Gd^Fmw, Rb, Re, Rb, Re, Re, Re
Hhd, Hhd, Hhd, Hhd, Rb, Re, Rb, Re, Rb, Re, Re, Gll^Fp, Gll^Fp, Rb, Gll^Fp, Re, Re^Es, Rb^Es, Re^Es, Re^Es, Rb, Re, Re, Re, Gd^Fdw, Re, Gd^Fdw
Hhd, Hhd, Hh, Hh, Hh, Hh, Re, Re, Rb, Rb, Gll^Fp, Gll^Fmw, Gll^Fmw, Gll^Fmw, Gll^Fmw, Gll^Fmw, Gll^Fp, Rb, Re, Rb^Es, Re, Re, Rb, Gd^Fdw, Gd^Fmw, Gd^Fdw, Gd^Fmw
Hhd, Hhd, Hhd, Hh, Rb, Re, Re^Es, Re, Rb, Re, Rb, Gll^Fp, Rb, Re, Rb, Gll^Fp, Re, Gll^Fp, Re^Es, Re^Es, Re, Gd^Fmw, Re, Gd^Fdw, Gd^Fmw, Gd^Fmw, Gd^Fmw
Rb, Hhd, Re, Hhd, Rb, Re^Es, Re, Gll^Fp, Gll^Fp, Re, Re, Re, Ce, Ce, Ce, Re, Rb^Es, Re^Es, Re^Es, Re, Gd^Fmw, Gd^Fmw, Gd^Fmw, Gd^Fmw, Rb, Gd^Fdw, Re
Rb, Rb, Re^Es, Re, Re^Es, Re^Es, Re, Gll^Fp, Gll^Fmw, Gll^Fp, Re, Rb, Ce, 1 Ke, 2 Ce, Rb, Re, Re^Es, Rb^Es, Rb, Rb, Re, Gd^Fdw, Re, Re^Es, Re, Rb
Re^Es, Re^Es, Re^Es, Re^Es, Re^Es, Rb, Rb, Gll^Fp, Gll^Fmw, Gll^Fp, Re, Rb, Re, Ce, Rb, Gll^Fp, Gll^Fmw, Gll^Fp, Re, Re^Es, Re, Re, Rb^Es, Rb^Es, Rb, Re^Es, Re
Re, Re^Es, Rb, Rb^Es, Re^Es, Re^Es, Rb, Re, Gll^Fp, Gll^Fmw, Gll^Fp, Re, Re, Rb, Gll^Fp, Gll^Fmw, Gll^Fmw, Gll^Fp, Gll^Fp, Re^Es, Re^Es, Re^Es, Re, Re, Re, Rb, Rb
Rb, Rb, Re, Re, Re^Es, Re^Es, Rb, Rb, Ss, Re, Re, Re, Rb, Gll^Fp, Gll^Fp, Gll^Fmw, Gll^Fmw, Re, Re, Re^Es, Re, Re, Re, Gd^Fdw, Gd^Fdw, Gd^Fdw, Gd^Fdw
Re, Rb, Re^Es, Re, Rb^Es, Re, Re, Ss, Re, Re, Rb^Es, Rb, Re^Es, Re, Re^Es, Re, Re, Re, Re, Re, Rb, Gd^Fmw, Gd^Fmw, Rb, Gd^Fmw, Gd^Fdw, Gd^Fdw
Rb, Rb, Rb, Re, Rb, Re^Es, Re^Es, Rb^Es, Re^Es, Re^Es, Rb, Rb^Es, Rb, Re^Es, Re, Rb^Es, Rb, Re, Re, Re, Re, Gd^Fmw, Gd^Fmw, Gd^Fmw, Gd^Fmw, Gd^Fdw, Gd^Fdw
Ss, Re, Rb, Rb, Re, Rb, Re, Re, Gd^Fmw, Gd^Fdw, Re, Rb, Rb, Rb, Re, Gll^Fp, Re, Gll^Fp, Re, Re, Re, Re, Gd^Fmw, Re, Gd^Fmw, Gd^Fmw, Re
Ss, Rb, Ss, Ss, Re^Es, Rb, Re, Gd^Fdw, Gd^Fmw, Gd^Fdw, Gd^Fmw, Rb, Re, Re, Gll^Fp, Gll^Fp, Gll^Fmw, Gll^Fmw, Gll^Fp, Re, Re, Re^Fmw, Gd^Fmw, Re, Re, Rb, Re
Ss, Ss, Ss, Rb, Re^Es, Re, Gd^Fdw, Gd^Fmw, Gd^Fmw, Gd^Fmw, Gd^Fdw, Ss, Rb, Re, Gll^Fp, Gll^Fp, Gll^Fmw, Gll^Fmw, Gll^Fmw, Gll^Fmw, Re, Re, Re^Es, Re, Re, Re, Rb
Re, Ss, Ss, Rb^Es, Rb, Re, Ss, Re, Re, Gd^Fmw, Rb, Ss, Re, Gll^Fp, Re, Gll^Fp, Gll^Fp, Gll^Fp, Gll^Fp, Gll^Fp, Gll^Fp, Re, Re^Es, Re, Gd^Fdw, Gd^Fdw, Gd^Fdw
Re, Re, Rb, Re, Re, Ss, Ss, Ss, Rb, Rb, Re^Es, Re, Rb^Es, Rb, Re, Gll^Fp, Re, Gll^Fp, Re, Gll^Fp, Re, Re, Gd^Fmw, Re, Gd^Fdw, Gd^Fmw, Gd^Fmw
Rb^Es, Re^Es, Re^Es, Re, Re, Rb, Re, Rb, Ss, Re, Rb, Re^Es, Re^Es, Re, Re, Gll^Fp, Re, Re, Re^Es, Rb, Re, Gd^Fmw, Gd^Fdw, Gd^Fdw, Gd^Fdw, Gd^Fmw, Gd^Fmw
Rb, Rb, Rb, Ss, Ss, Re, Rb, Re, Ss, Re, Ss, Re, Rb, Rb, Rb^Es, Re^Es, Re^Es, Re^Es, Re, Re, Gd^Fmw, Gd^Fmw, Gd^Fmw, Gd^Fmw, Gd^Fmw, Gd^Fmw, Gd^Fmw
Rb, Re, Rb, Ss, Rb, Rb, Ss, Ss, Ss, Ss, Re, Ss, Re, Rb, Rb^Es, Re^Es, Re, Re, Re, Gd^Fmw, Gd^Fdw, Gd^Fmw, Gd^Fmw, Gd^Fmw, Gd^Fdw, Gd^Fmw, Gg^Fmw
