Mm, Mm, Mm, Hh, Hhd, Gd, Gd, Gd, Re, Re, Gd^Fmw, Re, Re, Gd, Gs, Hh, Hh, Mm, Hh, Mm, Mm, Mm
Mm, Mm, Mm, Hh, Hhd, Gd, Gd, Gd, Re, Re, Gd^Fdw, Rb^Es, Re, Gd, Gs^Es, Hh, Hh, Mm, Hh, Mm, Mm, Mm
Mm, Mm, Hh, Hh, Hhd, Gd, Re, Re^Em, Re, Rb, Re, Re^Es, Re^Em, Gd, Gd^Es, Hhd, Hhd, Hh, Hh, Hh, Mm, Mm
Hh, Hh, Hh, Hhd, Gd, Gd, Re, Rb^Em, Re^Es, Re, Chs, Chs, 3 Khs, Chs, Chs, Gd, Gd, Gs, Gs^Es, Hh, Mm, Mm
Hh, Hh, Hh, Gs, Gd, Re, Re^Es, Re, Re^Es, Wwg, Chs, Chs, Chs, Chs, Chs, Re^Es, Gd, Gs^Es, Hh, Hh, Hh, Hh
Mm, Mm, Hh, Gs, Gd, Re, Gd^Fdw, Rb, Re, Wwg, Wwg, Chr, Chr, Chr, Wwg^Bw\, Re, Gs^Es, Hh, Gs, Hh, Gs, Gs
Hh, Hh, Hh, Hhd, Gd, Re, Re, Re, Re, Re^Es, Re, Wwg^Bw/, Wwg, Wwg, Re, Gs^Es, Re, Gs^Em, Re, Gs, Gs, Gs
Hhd, Hhd, Hhd, Hhd, Re, Rb, Re, Gd^Fmw, Rb^Es, Re^Es, Re, Re^Es, Rb, Rb, Re, Re^Es, Re, Re, Gd^Fdw, Re, Re, Re
Re, Re, Re, Re, Gd^Fmw, Gd^Fmw, Re, Re, Re, Re, Gd^Fdw, Re, Gd^Fmw, Re^Es, Re, Rb^Es, Re, Re^Es, Gd^Fmw, Gd^Fdw, Re, Re
Re, Re^Es, Re, Gd^Fdw, Re, Gd^Fdw, Re, Rb, Re, Gd^Fdw, Gd^Fdw, Gd^Fdw, Re, Re, Re, Gd^Fdw, Re, Gd^Fdw, Gd^Fmw, Gd^Fmw, Re, Re^Es
Re, Re, Gd^Fmw, Re, Re^Es, Re, Gd^Fmw, Re^Es, Re, Gd^Fmw, Gd^Fmw, Gd^Fmw, Re, Re^Es, Re, Re, Re, Re, Re, Re, Re, Re
Re, Re, Gd^Fmw, Re, Re, Gd^Fdw, Gd^Fdw, Gd^Fmw, Re, Re, Re^Es, Re, Gd^Fdw, Re, Re^Em, Gd^Fmw, Gd^Fmw, Re^Es, Re, Gd^Fdw, Re, Re
Re, Re, Re, Re, Re, Gd^Fdw, Gs, Gd, Gd, Re, Re, Gd^Fmw, Gd^Fdw, Gd^Fdw, Gd^Fdw, Gd^Fdw, Gd^Fdw, Re, Re, Re, Re, Re
Gs, Gd, Gs, Re, Gd^Fdw, Gd^Fdw, Gs, Gs, Gs^Es, Re, Re, Gd^Fmw, Gd^Fmw, Gd^Fmw, Gd^Fmw, Gd^Fmw, Re, Re, Gs, Gs, Gs, Gs
Gg, Gs, Gs, Re, Re, Gd^Fdw, Gd^Fdw, Gs, Gd^Fdw, Gd^Fdw, Gd^Fdw, Re, Re, Re, Re, Re, Re, Re, Gs^Fmw, Gs^Fmw, Gs^Fmw, Gs^Fms
Gg, Gg, Gs^Fmw, Gs^Fmw, Gs^Fmw, Re, Re, Re, Gd^Fmw, Gd^Fmw, Gd^Fdw, Re, Re^Es, Re, Gs^Fmw, Gs^Fdw, Gs^Fdw, Re, Gs^Fms, Gs^Fms, Gs^Fms, Gs^Fms
Gg, Gg, Gs^Fmw, Gs^Fmw, Gs^Fmw, Re, Re, Gd^Fdw, Gs, Gd^Fmw, Re, Re, Gs^Em, Re, Gs^Fmw, Gd^Fmw, Gd^Fdw, Re, Gg, Gs^Fms, Gs^Fms, Gs^Fms
Gg, Gg, Gs^Fmw, Gs^Fmw, Gs, Gs, Gs^Fmw, Re, Gs, Gs, Gg^Em, Gs, Gg, Gd^Fmw, Gd^Fdw, Gd^Fdw, Gg, Gg, Gs, Gs, Gs, Gs
Gs^Fmw, Gs, Gs, Gs, Gs^Fp, Gs^Fp, Gs^Fmw, Re, Gs^Fmw, Gs^Fmw, Gs^Fmw, Gg, Gs^Fms, Gs, Gs, Gs, Gg, Gs, Gs^Fmw, Gs^Fmw, Gs^Fmw, Gs^Fms
Gs^Fdw, Gs^Fp, Gg, Gg, Gs, Gs^Fp, Gs^Fdw, Gg, Gs^Fmw, Gs^Fmw, Gs^Fmw, Gg, Gg, Gg, Gs^Fms, Gs^Fms, Gs^Fms, Gs, Gs^Fms, Gs^Fms, Gs^Fms, Gs^Fms
Gs^Fms, Gs^Fms, Gs^Fmw, Gs^Fmw, Gs^Fmw, Gs^Fms, Gs^Fms, Gs^Fmw, Gs^Fmw, Gs^Fmw, Gg, Gs, Gs^Em, Gg^Em, Gs^Fms, Gs^Fms, Gs^Fms, Gs, Gg, Gs^Fms, Gs^Fms, Gs^Fms
Gs^Fms, Gs^Fms, Gs^Fmw, Gs^Fmw, Gs^Fmw, Gs^Fmw, Gg, Gs^Fmw, Gs^Fms, Gs^Fmw, Gg^Em, Gs, Gg, Gs^Fms, Gs^Fms, Gs^Fms, Gg, Gg, Gs, Gs^Fms, Gs^Fms, Gs^Fms
Gs^Fmw, Gs^Fmw, Gs^Fmw, Gs^Fmw, Gs^Fp, Gs^Fp, Gg, Ce, 1 Ke, Ce, Gg, Ce, 2 Ke, Ce, Gs^Fms, Gs^Fms, Gg, Gs, Gs, Gs, Gs, Gg
Gs^Fms, Gs^Fp, Gs^Fp, Gs^Fp, Gs^Fdw, Gs^Fp, Gs^Fdw, Ce, Gg, Ce, Gg, Ce, Gg, Ce, Gs^Fms, Gs^Fms, Gs^Fms, Gs, Gs, Gs, Gs^Fms, Gs^Fms
Gs^Fms, Gs^Fms, Gs^Fdw, Gs^Fp, Gs^Fms, Gs^Fms, Gs^Fms, Gs^Fms, Gg, Gg, Gs^Fms, Gs^Fms, Gs^Fms, Gg^Em, Gs^Fms, Gs^Fms, Gs^Fms, Gg, Gg, Gs^Fms, Gs^Fms, Gs^Fms
Gs^Fms, Gs^Fms, Gs^Fms, Gs^Fms, Gs^Fms, Gs^Fms, Gs^Fms, Gs^Fms, Gg, Gs^Fms, Gs^Fms, Gs^Fms, Gs^Fms, Gs^Fms, Gs^Fms, Gs^Fms, Gs^Fms, Gs^Fms, Gg, Gs^Fms, Gs^Fms, Gs^Fms
Gs^Fms, Gs^Fms, Gs^Fms, Gs^Fms, Gs^Fms, Gs^Fms, Gg, Gg, Gg, Gg, Gg, Gs^Fms, Gs^Fms, Gs^Fms, Gs^Fms, Gs^Fms, Gg, Gg, Gg, Gg, Gg, Gg
