Wo, Wwr, Ww, Ww, Ww, Ww, Ww, Ww, Ds, Ds, Ds, Ds, Gs, Gs, Gd, Gs, Gd, Gd, Gd, Gd, Gd, Gg
Wo, Wwr, Wwr, Ww, Ww, Ww, Ww, Ww, Cme, Ds, Ds, Ds, Gs, Gs, Ds, Gd, Gg, Gd, Gd, Gd, Hhd, Hhd
Wo, Wo, Wwr, Ww^Vm, Wwr, Ww, Ww, Cme, 4 Kme, Ds, Ds, Gs, Gs, Gs, Ds, Gs, Ds, Gs, Gd, Gd, Hhd, Hhd
Wo, Wo, Wo, Wo, Wo, Wwr, Ww, Cme, Cme, Cme, Ds, Ds, Hd, Hd, Ds, Ds, Ds, Ds, Ds, Hhd, Ww, Hhd
Wo, Wo, Wo, Wo, Wo, Wwr, Wwr, Wwr, Ww, Ww, Ww, Ds, Hd, Ds, Ds, Ww, Ww, Ww, Ww, Ww, Gs^Fds, Gs^Fds
Wo, Wo, Wo, Wo, Wo, Wo, Wwr, Ww, Ww^Vm, Ww, Ww, Ds, Ds, Gs^Vht, Gs, Ds, Ww, Ww, Ww, Gs^Vc, Hh^Fds, Gs^Fms
Wo, Wo, Wo, Wo, Wo, Wo, Wo, Ww, Wwr, Wwr, Ww, Ds, Ds, Gs, Gs, Ww, Hd, Ds, Ww, Gs^Fms, Hhd, Hh^Fds
Wo, Wo, Wo, Wo, Wo, Wo, Wo, Ds, Ww, Ww, Ds, Ds, Ds, Gs^Esd, Ds, Wwr, Hd, Ds, Ds, Hhd, Gs^Fds, Hh
Wo, Wo, Wo, Wo, Wo, Wo, Wo, Wwr, Wwr, Ww, Ww, Ds, Ww, Ds, Ww, Ww, Ds, Hd, Gg, Gs^Fds, Gs^Fds, Gs^Fds
Wo, Wo, Wo, Wo, Wo, Wo, Wo, Wo, Wwr, Ww, Ww, Ww, Gs, Ww, Wwr, Hd, Gs^Fds, Ds, Gg, Gs^Vc, Gg^Efm, Gs^Fds
Wo, Wo, Wo, Wo, Wo, Wo, Wo, Wo, Ww^Vm, Wwr, Ds, Ds, Gs, Gs, Ww, Hd, Gs^Fms, Gs^Fds, Gg, Gg, Gs^Fds, Gs^Fds
Wo, Wo, Wo, Wo, Wo, Wo, Wo, Wwr, Ww, Ww, Ds, Ds, Ds, Ds, Gs, Hh, Hh, Gs^Fds, Gg, Gg, Gg, Gg
Wo, Wo, Wo, Wo, Wo, Wo, Wo, Wwr, Ww, Ww, Ww, Ww, Hd, Ds, Gs, Gs^Vht, Gs, Gg, Gg, Hh, Hh, Hh
Wo, Wo, Wo, Wo, Wo, Wo, Ds, Ww, Cme, Cme, Cme, Hd, Ds, Gs^Esd, Gg, Gg, Gg, Gg, Gg, Gg, Hhd, Hhd
Wo, Wo, Wo, Wo, Wwr, Wo, Ww, Ww, Cme, 3 Kme, Cme, Hd, Ds, Ds, Gs, Gg, Gg, Gg^Efm, Gs^Fds, Hh, Gs^Fds, Hhd
Wo, Wo, Wo, Wwr, Ww^Vm, Wwr, Ww, Ww, Ds, Ds, Ds, Ds, Ds, Gs, Gg, Gg, Gg, Gg, Gs^Fds, Gs^Fds, Gg^Fet, Gs^Fds
Ww, Wo, Wwr, Wwr, Ww, Ww, Ww, Ww, Ds, Ds, Ds, Gs, Gs^Esd, Gs, Gs, Gg, Re, Gs, Gg^Ve, Gs^Fds, Gs^Fds, Gs^Fms
Ww, Ww, Ww, Ww, Ww, Ww, Ds, Ds, Ds, Ds, Gs^Vht, Gs, Gs, Gs, Gg, Gs^Fds, Re, Gs, Gs, Gs^Fds, Gd, Gs^Fms
Wwr, Ww, Wwr, Wwr, Wwr, Wwr, Ds, Ds, Gs, Ds, Gg, Gg, Gg, Gg, Gg, Gg, Re, Gs, Ce, Gs, Gd, Gd
Wwr, Ww, Ww, Ww, Ds, Ds, Ds, Ds, Gs, Gs, Gs, Gg, Gs^Fds, Gg^Efm, Gs^Fds, Gg, Re, Ce, 1 Ke, 2 Ce, Gd, Gd
Ww, Ww, Ww, Ds, Ds, Ds, Ds, Ds, Ds, Ds, Gs, Gs, Gs^Fds, Gs^Fds, Gs^Fds, Gg, Re, Ce, Ce, Ce, Gg, Gg
Ww, Ww, Ww, Ds, Ds, Ds, Ds, Ds, Gs, Gs, Gs, Gs^Fds, Gs^Fds, Gs^Fms, Gs^Fms, Gs^Fms, Re, Re, Gg, Gg, Gg, Gg
