Gg, Gg, Gg, Gg, Gg, Gs, Gs^Em, Re, Ss, Ss, Wwg, Ss, Ss, Ss, Ss, Ss, Rb, Rb, Rb, Ss, Ss, Ss
Gg, Gg^Em, Gg, Gg^Em, Gg, Gs, Gs, Re, Ss, Ss, Wwg, Ss, Ss, Ss, Ss^Vhs, Ss, Rb, Re^Em, Rb, Ss, Ss, Ss
Re, Re, Ce, Ce, 2 Ce, Gs^Em, Re, Re, Ss, Ss, Wwg, Ss, Ss, Ss, Rb, Rb, Gs, Gs, Gs^Em, Rb, Rb, Rb
Gg, Gg, Ce, 1 Ke, Ce, Gs, Ss, Ss^Vhs, Wwg, Ss, Ss, Ss, Wwg, Ss, Rb, Gs^Em, Rb, Rb, Rb, Gs, Rb, Re
Gg, Gg, Gg, Ce, Gs, Re, Wwg^Bw\, Wwg, Ss, Ss, Ss, Ss, Re, Wwg, Wwg^Bw/, Rb, Ss, Ss^Vhs, Ss, Rb, Ss, Ss
Gg, Gg^Vc, Gs^Fp, Gs^Em, Re^Em, Re, Wwg, Rb, Re, Ss^Vhs, Rb, Rb, Gs, Rb, Ss, Ss, Ss, Ss, Ss, Ss, Ss, Ss
Gs^Fdw, Gs^Em, Gs^Fmw, Gs, Re, Wwg, Ss, Rb, Rb, Rb, Rb, Gs, Gs^Em, Rb, Ss, Wwg, Wwg, Wwg, Ss, Wwg, Ss, Ss
Gs^Fp, Gs^Fdw, Wwg, Gs, Wwg, Wwg, Wwg, Ss, Rb, Gs, Gs, Rb, Rb, Rb, Ss^Vhs, Wwg, Ss, Ss, Ss, Ss, Ss, Ss
Wwg, Wwg, Gs^Fp, Wwg, Rb, Ss, Ss, Ss, Rb, Gs, Rb, Re, Rb, Rb, Ss, Wwg, Rb, Rb, Rb, Ss, Ss, Ss
Gs^Fp, Gs^Fp, Gs^Fmw, Rb, Ss^Vhs, Ss, Ss, Wwg, Wwg^Bw/, Rb, Wwg, Rb, Wwg, Wwg^Bw\, Rb, Ss, Rb, Gs, Rb, Ss^Vhs, Ss, Ss
Gg, Gs, Rb, Ss, Ss, Ss, Rb, Wwg^Bw/, Ss, Ss, Ss, Wwg, Ss, Ss, Ss, Rb, Rb, Gs^Em, Rb, Rb^Es, Ss, Ss
Gg, Gs, Rb, Ss, Ss, Ss, Rb, Ss, Rb, Ss^Vhs, Rb, Ss, Wwg, Ss, Ss, Ss, Ss^Vhs, Rb, Rb, Rb, Ss, Ss
Gg, Gs, Rb, Ss, Ss, Ss, Ss, Rb, Gs, Rb^Edp, Gs, Rb, Rb, Wwg, Ss, Ss, Ss, Rb, Wwg^Bw\, Wwg, Wwg, Wwg
Gg, Gs, Gs, Rb, Rb, Ss, Ss, Rb, Gs, Hh, Hh, Gs, Rb, Ss, Ss, Wwg, Wwg, Wwg, Rb, Rb, Ss, Ss
Gg, Gg, Gs, Re, Ss, Ss, Ss, Rb, Rb, Gs^Em, Rb, Re, Rb, Ss, Wwg, Ss, Ss, Ss, Rb^Edp, Re, Ss, Ss
Gs, Gs^Em, Gs, Rb, Ss^Vhs, Ss, Ss, Ss, Wwg^Bw/, Rb, Ss^Vhs, Rb, Ss, Wwg^Bw\, Rb, Rb, Re, Ss^Vhs, Rb^Es, Ss, Ss, Ss
Gs^Fp, Gs^Fdw, Gs, Rb, Rb, Rb, Rb, Rb, Ss, Ss, Ss, Ss, Wwg, Ss, Re, Rb^Es, Rb^Es, Rb, Rb, Ss, Ss, Ss
Gs^Fp, Gs^Fp, Gs^Fmw, Gs, Gs, Gs, Gs, Rb, Ss, Ss, Ss, Ss, Wwg, Ss, Rb^Es, Rb, Cer, Cer, Cer, Re^Es, Ss, Ss
Gs, Gs, Gg, Gs^Fdw, Gg, Gg^Em, Gs, Rb, Rb, Ss, Ss, Ss, Wwg, Ss, Ss, Rb, Cer, 3 Ker, Cer, Ss, Ss, Ss
Gg, Gg, Gg^Vc, Gg, Gg, Gg, Gg, Gs, Rb, Ss^Vhs, Ss, Wwg, Ss, Ss, Ss, Rb, Rb^Es, Cer, Ss, Ss, Ss, Ss
Gg, Gg, Gg, Gg, Gg, Gg, Gs, Gs^Em, Gs, Rb, Ss, Ss, Ss, Wwg, Ss, Ss^Vhs, Ss, Ss, Ss, Ss, Ss, Ss
Gg, Gg, Gg, Gg, Gg, Gg, Gg, Gs, Gs, Rb, Ss, Ss, Ss, Wwg, Ss, Ss, Ss, Ss, Ss, Ss, Ss, Ss
